200 10
              S                S                         R            S       R                                                                    R         R                                          |
              S                                                      S                                                S                          R                  R                  M                |
                                           S                                                              L                            S                                                                |
                                           S                                                                                                       R                                                    |
                                            S                      S                                 M                                                                                             P    |
                                                                                                          R                     S                 M                                                     |
                                                          S  S                                                                                                               S                          |
              S                                          L                      S                             S                                              S                                          |
              S                 S                        L                    L 1                                                        L                                                              |
--------------------------------------------------------------------------------------------------------------------------------------------------------------------------------------------------------|
              1                S                         S                    S                                        R                                            RR         2 2    2  2              |
                                                                                                                      R                                             R                                   |
                                                                                                          S                                                                                          S  |
                                                                                                                                                   1                                              S     |
                                           S                      S                                 M                                                                                         M         |
                                                                                                          S                                       M                                                     |
                                                                                                                                                                                                        |
                                                                                                              S                                              S                                     S    |
              1                 L                        L                      1              L                                                                                3 3    3  3             |
--------------------------------------------------------------------------------------------------------------------------------------------------------------------------------------------------------|
              S                S                         S                    1                                                    1                                                                    |
                   M                                                                                                  S                                             S                  M                |
                                                                                                          S                                                                                             |
                                                                                                                                                   1                                              1     |
                                           S                      S                                 M                                                                S                                   |
                                           M                                                              S                                       M                                                     |
                                                                                                    M                                                                        S                          |
                   M                                                                                          S                                              S                                     1    |
              S                 S                        S                      1                                                                                                                       |
--------------------------------------------------------------------------------------------------------------------------------------------------------------------------------------------------------|
              1                S                         S                    1                                                                                                                         |
                                                                                                                      S                                             S                  M                |
                                                                                                          S                                                                                             |
                                                                                                                                                   1                                              1     |
                                           S                      S                                 M                                                                                                   |
                                                                                                          S                                       M                                                     |
                                                                                                                                                                             S                          |
                                                                                                              S                                              S                                     1    |
              1                 S                        S                      1                                                                                                                       |
--------------------------------------------------------------------------------------------------------------------------------------------------------------------------------------------------------|
              1                S                         S                    1                                                                                                                         |
                                                                                                                      S                                             S                  M                |
                                                                                                          S                                                                                             |
                                                                                                                                                   1                                              1     |
                                           S                      S                                 M                                                                                                   |
                                                                                                          S                                       M                                                     |
                                                                                                                                                                             S                          |
                                                                                                              S                                              S                                     1    |
              1                 S                        S                      1                                                                                                                       |
--------------------------------------------------------------------------------------------------------------------------------------------------------------------------------------------------------|

