200 10
              S                S                         R            S       R                                                                    R         R                                          |
              S                                                      S                                                S                          R                  R                  M                |
                                           S                                                              L                            S                                                                |
                                           S                                                                                                       R                                                    |
                                            S                      S                                 M                                                                                                  |
                                                                                                          R                     S                 M                                                     |
                                                          S  S                                                                                                               S                          |
              S                                          L                      S                             S                                              S                                          |
              S                 S                        L                    L 1                                                        L                                                              |
--------------------------------------------------------------------------------------------------------------------------------------------------------------------------------------------------------|
              1                S                         S                    S                                        R                                                                                |
                                                                                                                      R                                                                                 |
                                                                                                          S                                                                                             |
                                                                                                                                                   1                                                    |
                                           S                      S                                 M                                                                                                   |
                                                                                                          S                                       M                                                  B  |
                                                                                                                                                                                                        |
                                                                                                              S                                                                                         |
              1                 L                        L                      1              L                                                                                                        |
--------------------------------------------------------------------------------------------------------------------------------------------------------------------------------------------------------|
              S                S                         S                    1                                                    R                      R                                 R           |
                   M                                                                                                  S                                             R                  R                |
                                                    1                                               M                                                                                                   |
                                                                                                                                         1         R                                              R     |
                              1            S                      S              1                  M                                                                R                                  |
                                           M                                                                             1                        M                                                     |
                                                                                                    M                                                                        L                          |
                   M                                                                                                               1                         L                                     L    |
              S                 S                        S                      1                   M                                            L                                 L                    |
--------------------------------------------------------------------------------------------------------------------------------------------------------L----------------L------------------L-----------|
              1                S                         2        2           2                                S                                                                                        |
                                                         2                      2                             S                              M                                                          |
                                                                                                             S                                                                                          |
                    1                                                                                       S                    M                                                                      |
                                           S                      M                                        S                                                                                        P   |
                                1                                 M                                 M     S                                       M                                                     |
                                                                                                           S                                                                                            |
                                     1                                                                       S                              M                                                           |
              1                 S                        3                      3                             S                                                                                         |
---------------------------------------------------------3--------3------------3-------------------------------S----------------------------------------------------------------------------------------|
                                                                                                                                                                                                        |
                                                                                                                                                                                                        |
                                                                                                                                                                                                        |
                                                                                                                                                                                                        |
                                                                                                                                                                                                        |
       E                                                                                                                                                                                                 |
                                                                                                                                                                                                        |
                                                                                                                                                                                                        |
                                                                                                                                                                                                        |
--------------------------------------------------------------------------------------------------------------------------------------------------------------------------------------------------------|
